system = система
programme (Br.) program (Am.) = программа
phone = телефон
data = данные
computer = компьютер
call = телефонный звонок
message = сообщение
network = компьютерная сеть
radio = радио (рация)
communication = связь (коммуникация)
connection = подключение (связь)
Internet = интернет
device = устройство
application = приложение, программа
hardware = компьютерное «железо»
software = программное обеспечение
email = электронная почта
settings = настройки
user = пользователь
resolution = разрешение (экрана)
chip = чип (комп.)
link = ссылка (в интернете)
display = дисплей
mail = почта
net = сеть
content = содержание (контент)
keyboard = клавиатура
laptop = ноутбук
PC (personal computer) = ПК, персональный компьютер
tablet (tablet computer) = планшетный компьютер
