victim = жертва
threat = угроза
felony = преступление (тяжелое, уголовное)
misdemeanor = мелкое преступление
attorney = адвокат
judge = судья
safety = безопасность
investigation = расследование
murder = убийство
justice = справедливость
danger = опасность
jury = жюри (присяжные)
judgment = суждение (решение суда)
witness = свидетель
incident = инцидент
legislation = законодательство, законы
sentence = приговор
prosecutor = прокурор
investigator = следователь
lawyer = адвокат
suicide = самоубийство
enforcement = принуждение к исполнению закона
prisoner = заключенный, пленник
inmate = заключенный
jail = тюрьма
killer = убийца
gang = банда
advocate = адвокат
lawsuit = иск
testimony = свидетельство, показания
penalty = карательная мера
offense = правонарушение
terrorist = террорист
assault = нападение
proof = доказательство
violation = нарушение
crime = преступление
cell (prison) = камера (тюремная), клетка
trial = испытание (судебный процесс)
prison = тюрьма
evidence = улика
gun = пистолет
protection = защита
court = суд
security = безопасность (охрана)
officer = офицер, должностное лицо
cop = коп (полицейский)
police = полиция
guard = охранник
law = закон
will (document) = завещание
violence = насилие
responsibility = ответственность
