home = дом
room = комната
house = дом (здание)
door = дверь
view = вид
table = стол
court = (внутренний) дворик, корт
wall = стена
window = окно
floor = пол (этаж)
bed = кровать
chair = стул
garden = сад
kitchen = кухня
bedroom = спальня
living room = гостиная
bathroom = туалет, ванная
basement = подвал
fan = вентилятор
spot = пятно
screen = экран
flat (Br.) apartment (Am.) = [əˈpɑːtmənt= квартира
living = проживание
key = ключ
pool = бассейн
desk = стол (письменный, рабочий)
visitor = посетитель
guest = гость
hall = зал
mirror = зеркало
telephone = телефон
household = домашнее хозяйство
gate = ворота
roof = крыша
housing = жилье
dormitory, dorm = [dɔːm= общежитие (студенческое)
pot = горшок
knife = нож
recipe = рецепт
roll = рулон
clock = часы (настенные)
ceiling = потолок
fence = забор
furniture = мебель
wardrobe = шкаф (для одежды)
stair = лестница, ступенька
entrance = вход
exit = выход
oven = печь
comfort = комфорт
shelf = полка
can = консервная банка
lawn = газон
case = кейс (футляр)
card = карточка
stuff = вещи, хлам (барахло)
box = коробка
item = предмет
collection = коллекция
tape = лента
cover = крышка, покрытие, обложка
lid = крышка
bowl = чаша
frame = рамка
album = альбом
tube = тюбик (трубка)
pack = упаковка
a bunch of = куча чего-то
match = спичка
cigarette = сигарета
thing = вещь
glass = стакан
