Injury = повреждение\травма
Illness = плохое самочувствие\временное недомогание\недомогание\простуда
Sickness = плохое самочувствие\временное недомогание\недомогание\простуда\тошноту
Disease = тяжелая болезнь\болезнь
medical insurance = медицинская страховка
health = здоровье
diagnosis = диагноз
pulse = пульс
doctor = врач
hygiene = гигиена
illness (disease) = болезнь
recovery = выздоровление
injury = травма, повреждение
cough = кашель
cold = простуда
dose = доза
crutch = костыль
wheelchair = инвалидная коляска
painkiller = болеутоляющее средство
patient = пациент
dropper = капельница
patch (plaster) = пластырь
side-effect = побочное действие
sleeping pills = снотворное
thermometer = термометр
surgery = операция (хирургия)
syringe = шприц
medical examination = медосмотр
blood pressure = кровяное давление
urine test = анализ мочи
drug test = анализ на наркотики
X-ray = рентген
treatment = лечение
therapy = терапия
prescription = рецепт
medicine (drug) = лекарство
injection (shot) = укол
pharmacy (drugstore) = аптека
pills = таблетки
ointment = мазь
ambulance = скорая помощь
bandage = бинт, повязка
first aid = первая помощь

Ache — это боль в медицинском понимании, сосредоточенная в одном месте: 
головная боль — headache, зубная боль — toothache.
Pain — это боль в более широком, бытовом понимании, как правило сильная, 
неожиданная. Например, если укусит собака или попасть молотком по пальцу 
— это pain.
Hurt — обычно используется не как существительное, а как неправильный 
глагол to hurt — 1) испытывать боль, 2) причинять боль, травму.

abscess	= абсцесс\нарыв
ache (pain, hurt) = боль
allergy = аллергия
asthma = астма
bronchitis = бронхит
bruise = синяк
burn = ожог
cancer = рак
cold = простуда
cold (in the head) = насморк
cut = порез
diabetes = диабет
diarrhea = диарея
fever = повышенная температура
flu (influenza) = грипп
fracture = перелом
giddiness (dizziness) = головокружение
headache = головная боль
heart attack = сердечный приступ
pus = гной
rash = сыпь
sickness = тошнота (также: болезнь)
stroke = инсульт
sunstroke = солнечный удар
symptom = симптом
toothache = зубная боль
wound = рана
gunshot wound = огнестрельное ранение
doctor = доктор, врач
nurse = медсестра
physician = врач (медик, терапевт)
veterinarian = ветеринар
family doctor = семейный врач (лечащий врач)
dentist = дантист
surgeon = хирург
anesthesiologist = анестезиолог
cardiologist = кардиолог
traumatologist = травматолог
orthopedist = ортопед
gastroenterologist = гастроэнтеролог
dermatologist = дерматолог
gynecologist = гинеколог
urologist = уролог
ophthalmologist = окулист, офтальмолог
therapist = физиотерапевт
pediatrician = педиатр
healer = целитель
height = рост
weight = вес
body = тело
head = голова
neck = шея
shoulder = плечо
arm = рука (полностью)
hand = рука (кисть)
wrist = запястье
forearm = предплечье
chest = грудь
back = спина
lower back = поясница
leg = нога
foot = ступня
knee = колено
joints = суставы
bones = кости
stomach = желудок\живот
lung = лёгкое
brain = мозг
liver = печень
spine, backbone, spinal column = позвоночник
kidney = почка
heart = сердце
skeleton = скелет
skull = череп
ribs = ребра
skin = кожа