city = большой город
town = маленький город
road = дорога
building = здание
street = улица
bar = бар
station = станция
trip = поездка
hotel = отель
yard = двор
neighborhood = район (окрестность)
park = парк
village = деревня
resident = житель
club = клуб
district = район
crowd = толпа
block = квартал
shop = магазин
construction = строительство
tour = тур
restaurant = ресторан
bridge = мост
traffic = дорожное движение
museum = музей
emergency = чрезвычайная ситуация
airport = аэропорт
address = адрес
beach = пляж
opening = открытие
route = маршрут
post office = почта
settlement = поселение
parking lot (Am.), car park (Br.) =, [kɑː pɑːk= парковка
stop = остановка
tower = башня
mayor = мэр
highway = шоссе
bench = скамья
sightseeing = осмотр достопримечательностей
column = колонна
resort = курорт
