season = время года
winter = зима
spring = весна
summer = лето
fall (Am.) autumn (Br.) = [ˈɔːtəm= осень
January = январь
February = февраль
March = март
April = апрель
May = май
June = июнь
July = июль
August = август
September = сентябрь
October = октябрь
November = ноябрь
December = декабрь
Monday = понедельник
Tuesday = вторник
Wednesday = среда
Thursday = четверг
Friday = пятница
Saturday = суббота
Sunday = воскресенье
week = неделя
day = день
night = ночь (вечер)
month = месяц
hour = час
minute = минута
morning = утро
moment = момент
century = век
period = период
future = будущее
second = секунда
time = время
year = год
decade = десять лет
evening = вечер
past = прошлое
beginning = начало
date = дата
era = эра
present (time) = настоящее
afternoon = день (время суток)
