study = изучение (исследование)
campus = кампус
curriculum = учебный план
laboratory (lab) = [læb= лаборатория
graduate = выпускник
mark (US), grade (UK) = оценка, отметка
library = библиотека
discipline = дисциплина
major = специальность (в учебе)
educator = педагог
testing = тестирование
specialist = специалист
teacher = учитель
professor = профессор
school = школа
student = студент
history = история
education = образование
college = колледж
class = класс, урок
test = тест
degree = степень (в т.ч. ученая степень)
training = обучение
knowledge = знание
coach = тренер
university = университет
lesson = урок
failure = неудача
learning = изучение, учеба
classroom = класс (помещение)
session = сеанс, период
preparation = подготовка
draft = набросок (черновик)
set = набор
