book = книга
author = автор
page = страница
language = язык
article = статья (напр. в газете)
character = характер (персонаж)
reader = читатель
text = текст
title = название
critic = критик
context = контекст
writing = написание, почерк, письмо (процесс письма)
literature = литература
reading = чтение
novel = роман
tale = сказка, история
story = история, рассказ
mystery = тайна, мистика
publication = публикация
poem = стихотворение
essay = эссе, сочинение
drama = драма, постановка в театре или на ТВ
fiction = вымысел
journal = дневник (журнал)
episode = эпизод
adventure = приключение
tragedy = трагедия
poet = поэт
poetry = поэзия
plot = сюжет
writer = писатель
