breakfast = завтрак
lunch = обед (ланч)
dinner = обед
supper = ужин
food = еда
coffee = кофе
wine = вино
salt = соль
fat = жир
sugar = сахар
fruit = фрукты
meal = еда (блюдо)
bottle = бутылка
meat = мясо
beer = пиво
pepper = перец
vegetables = овощи
dish = блюдо
cream = сливки
drink = напиток
taste = вкус
milk = молоко
cheese = сыр
bread = хлеб
tea = чай
alcohol = алкоголь
potato = картофель
sauce = соус
juice = сок
beans = бобы
tomato = помидор
butter = сливочное масло
spoon = ложка
fork = вилка
knife = нож
corn = кукуруза
cake = пирог, торт
onion = лук
ingredient = ингредиент
chocolate = шоколад
apple = яблоко
rice = рис
salad = салат
honey = мед
garlic = чеснок
cup = чашка
plate = тарелка
