clothes = одежда
sweater = свитер
pullover = пуловер
cardigan = кардиган
vest = жилет
jacket = пиджак (куртка)
coat = пальто
lightweight jacket = легкая куртка
down filled coat (down padded coat) = [daʊn ˈpædɪd kəʊt= пуховик
jeans = джинсы
pants, trousers = брюки
shorts = шорты
board shorts = бордшорты
briefs = плавки
tuxedo = смокинг
underwear = нижнее белье
thermal underwear = термальное белье
socks = носки
robe = халат
dress = платье
casual dress = повседневное платье
wear to work dress = строгое (деловое) платье
cocktail dress = коктейльное платье
evening dress = вечернее платье
top = топ
blouse = блузка
tunic = туника
skirt = юбка
leggings = леггинсы
swimsuit = купальник
bikini = бикини
one-piece (swimsuit) = слитный купальник
cover-up = накидка
lingerie = дамское белье
bra = бюстгальтер
panties = трусики (женские или детские)
mittens = митенки (также: варежки)
footwear = обувь
shoes = туфли
athletic shoes = спортивная обувь
boots = ботинки, бутсы, сапоги
sandals = сандали
slippers = тапочки
work shoes (safety shoes) = [ˈseɪfti ʃuːz=) спецобувь (рабочая)
accessories = аксессуары
belt = ремень
buckle = пряжка (ремня)
suspenders = подтяжки
sunglasses = солнцезащитные очки
necktie = галстук
cuff links = запонки
scarf = шарф
gloves = перчатки
hat = шляпа
cap = кепка
wallet = бумажник
handkerchief = платок
purse (handbag) = дамская сумочка
fabric = ткань
fleece = флис
leather = кожа
wool = шерсть
cotton = хлопок
fur = мех
denim = джинсовая ткань
suede = замша
silk = шелк
