director = директор, режиссер
position = положение (должность )
worker = работник
staff = персонал
lawyer = адвокат
executive = управленец, топ-менеджер
manager = менеджер
employee = сотрудник
agent = агент
farmer = фермер
analyst = аналитик
engineer = инженер
secretary = секретарь
physician = врач
journalist = журналист
designer = дизайнер
retirement = выход на пенсию
consultant = консультант
doctor = врач
teacher = учитель
driver = водитель
cook = повар
artist = художник
administrator = администратор
CEO = генеральный директор
deputy = заместитель
assistant = ассистент
correspondent = корреспондент
counselor = советник, консультант
editor = редактор, главный редактор
producer = производитель (продюсер)
master = мастер (капитан корабля)
boss = босс
personnel = персонал
dealer = дилер, продавец
head = руководитель
reporter = репортер
chairman = председатель
chief = шеф (глава)
adviser = советник
profession = профессия
professional = профессионал
