life = жизнь
death = смерть
birth = рождение
soul = душа
funeral = похороны
fate = судьба
wisdom = мудрость
lifetime = жизнь (продолжительность всей жизни)
boy = мальчик
girl = девушка
guy = парень
baby = малыш
adult = взрослый
youth = молодежь
childhood = детство
teenager (сокр. teen) = подросток
man = человек (мужчина)
woman = женщина
child = ребенок
kid = ребенок
twins = близнецы
identity = личность (установленная личность)
person = человек, персона
individual = личность (индивид)
human = человек
beauty = красота, красотка
personality = личность (персоналия)
gentleman = джентльмен
lady = леди
name (first name) = [fɜːst neɪm= имя
last name (Am) surname (Br) = [ˈsɜː neɪm= фамилия
date of birth = дата рождения
birthday = день рождения
sex = пол, секс
female (person) = женщина
male (person) = мужчина
talent = талант
risk = риск
ability = способность
height = рост
weight = вес
age = возраст
hand = рука (кисть)
eye = глаз
body = тело
face = лицо
heart = сердце
arm = рука (полностью)
hair = волосы
mouth = рот
neck = шея
lips = губы
head = голова
back = спина
foot = нога (ступня)
leg = нога (полностью)
shoulder = плечо
skin = кожа
finger = палец
brain = мозг
ear = ухо
bone = кость
knee = колено
breast = грудь
muscle = мышца
chest = грудь
nose = нос
tooth = зуб
throat = горло
stomach = желудок
hip = бедро
cheek = щека
voice = голос
look = взгляд
breath = дыхание
sight = зрение
hearing = слух
tongue = язык (биол.)
gesture = жест
step = шаг
sleep = сон
profile = профиль
tear = слеза
sense = чувство (физ.)
touch = прикосновение
