now = сейчас
then = затем
never = никогда
again = снова
always = всегда
today = сегодня
long = долго
ever = вечно
later = позже
(one year) ago = (один год) назад
early = рано
soon = скоро
recently = недавно
before = до
PM = после полудня
tonight = этой ночью (вечером)
AM = до полудня
late = поздно
forever = навсегда
rarely = редко
tomorrow = завтра
yesterday = вчера
currently = в настоящее время
already = уже
previously = ранее, в прошлый раз
whenever = всякий раз, когда
just = только что (всего лишь)
sometimes = иногда
finally = наконец
quickly = быстро
suddenly = вдруг
immediately = немедленно
frequently = часто
meanwhile = тем временем
occasionally = иногда
initially = изначально
shortly = коротко, вскоре
gradually = постепенно
ultimately = в конечном счете
regularly = регулярно
eventually = в конечном итоге
rapidly = быстро
newly = вновь, только что
primarily = в первую очередь
constantly = постоянно
originally = изначально (по происхождению)
often = часто
