fast = быстро
well = хорошо
even = даже
too = слишком
usually = обычно
exactly = точно
ok = хорошо
clearly = ясно
directly = непосредственно
absolutely = абсолютно
completely = полностью
easily = с легкостью
slowly = медленно
highly = высоко
mostly = в основном
seriously = серьезно
totally = полностью
merely = просто
typically = обычно
simply = просто
nearly = почти
carefully = тщательно
somehow = как-нибудь
truly = действительно
hardly = с трудом
significantly = значительно
entirely = полностью
necessarily = обязательно
specifically = специально
surely = уверенно, безусловно
heavily = сильно
strongly = сильно
quietly = тихо
effectively = эффективно
precisely = точно
normally = обычно
roughly = примерно (грубо)
gently = мягко
naturally = естественно
partly = частично
properly = правильно
slightly = немного
straight = прямо
definitely = определенно
virtually = практически
literally = буквально
politically = политически
relatively = относительно
personally = лично
likely = вероятно
similarly = аналогично, похоже
potentially = потенциально
