work = работать
keep (kept, kept) = хранить
help = помогать
write (wrote, written) = писать
provide = обеспечивать
pay (paid, paid) = платить
lead (led, led) = лидировать (возглавлять)
create = создавать
serve = служить
build (built, built) = строить
develop = развивать (разрабатывать)
base = базировать, размещать
realize = реализовать, осознавать
save = сохранять, спасать, делать сбережения
fail = терпеть неудачу
check = проверять
design = разрабатывать
claim = предъявлять претензии, заявлять о правах, утверждать
establish = устанавливать
maintain = поддерживать
head = руководить (возглавлять)
control = контролировать
apply = подавать заявление, применять что-то
manage = управлять
perform = выполнять
improve = улучшать
sign = подписывать
test = проверять (тестировать)
prevent = предотвращать
publish = публиковать
achieve = достигать (добиваться чего-то)
conduct = проводить
attend = участвовать, посещать
complete = выполнять
handle (Handle with care) = обращаться (работать с чем-либо, обычн. вручную)
handle (I can handle it) = справляться (напр. с проблемой)
deliver = доставлять
operate = управлять (обычно механизмом, машиной, программой)
order = приказывать, заказывать
measure = измерять
engage = входить в контакт, заниматься
hire = нанимать на работу
train = обучать
paint = красить
direct = руководить (управлять), направлять
solve = решать (проблему, задачу)
file = вносить в записи
employ = принимать на работу
make (made, made) = делать, заставлять
try = пробовать, пытаться
happen = случаться
set (set, set) = устанавливать
seek (sought, sought) = искать
fill = заполнять
pass = проходить, передавать
attempt = пытаться
connect = подключать (соединять)
record = записывать
locate = обнаружить (выяснить местоположение)
search = искать (search for), обыскивать
select = выбирать, избирать
launch = запускать
adjust = настраивать
succeed = достигать цели (преуспевать в чем-то)
review = пересматривать, делать обзор
arrange (an event) = организовывать (мероприятие)
benefit = получать выгоду
coach = тренировать
exercise = упражняться
monitor = наблюдать
supply = обеспечивать
assist = помогать
construct = строить
schedule = составлять график, вносить в график
assign = назначать, давать задание
dismiss = увольнять
practiсe = практиковаться
illustrate = иллюстрировать
enhance = улучшать, усиливать
implement = выполнять, применять
preserve = сохранять (уберегать)
guide = вести (направлять)
deserve = заслуживать чего-то
face (something) = встретиться с чем-то (напр. с проблемой)
cause = причинять что-либо