reach = достигать (дотягиваться)
catch (caught, caught) = ловить
drop = ронять
hang (hung, hung) = повесить
touch = прикасаться
clear = очищать
pour = лить (напр. воду)
stir = перемешивать
clean = чистить, убирать (мыть, приводить в порядок)
wrap = заворачивать
wash = стирать (мыть)
ring (rang, rung) = звонить
embrace = обнимать
hug = обнимать
put (put, put) = класть (помещать)
use = использовать
show = показывать
hold (held, held) = держать
open = открывать
cut (cut, cut) = резать
pull = тянуть
break (broke, broken) = ломать
cover = прикрывать
draw (drew, drawn) = тянуть
point = указывать (на что-либо)
close = закрывать
replace = заменять
collect = собирать, забирать
grab = хватать
tie = связывать
press = давить
link = соединять, проводить связь между фактами
mix = перемешивать
stretch = растягивать
hand = подавать что-то, передавать из рук в руки
knock = стучать
bend (bent, bent) = гнуть
lock = запирать на замок
tear (tore, torn) = рвать
pack = упаковывать
attach = прикреплять
dig (dug, dug) = копать
bind (bound, bound) = связывать (веревкой)
wind (wound, wound) = закручивать
wipe = протирать
load = загружать
sweep (swept, swept) = мести
squeeze = сжимать
rub = тереть
tap = постукивать
spin (spun, spun) = вращать
plant = сажать (растение)
pick = выбирать
gather = собирать (вместе)
hide (hid, hidden) = прятать (-ся)
blow (blew, blown) = дуть
smoke = курить
act = действовать
do (did, done) = делать
demonstrate = демонстрировать
lean = прислоняться, наклоняться
fix = чинить
nod = кивать
pose = позировать
send (sent, sent) = отправлять
burn (burnt\burned, burnt\burned) = сжигать
shut (shut, shut) = закрывать
line = выстраивать в линию
arrange = приводить в порядок (расставлять)
install = устанавливать
