say (said, said) = сказать
tell (told, told) = говорить
call = звать, звонить
ask = спрашивать, просить
talk = разговаривать
meet (met, met) = знакомиться (встречать)
understand (understood, understood) = понимать
speak (spoke, spoken) = говорить
allow = позволять
offer = предлагать
consider = рассматривать, считать
suggest = предлагать
require = требовать, нуждаться
report = докладывать
explain = объяснять
thank = благодарить
agree = соглашаться
describe = описывать
represent = представлять (напр. компанию)
lie = лгать
tell the truth (told, told) = говорить правду
mean (meant, meant) = иметь в виду
argue = спорить
wonder = интересоваться
name = называть, именовать
answer = отвечать
state = делать заявление
discuss = обсуждать
laugh = смеяться
guess = догадываться
prove = доказывать
sound = звучать
respond = отвечать
reveal = выявлять, раскрывать
treat = лечить (обращаться с кем-либо)
affect = влиять (воздействовать)
mention = упоминать
care = заботиться, беспокоиться, относиться не безразлично
avoid = избегать
support = поддерживать
sing (sang, sung) = петь
address = обращаться к кому-то
smile = улыбаться
admit = признать
assume = предполагать
refer = ссылаться на что-то, направлять, отсылать
announce = объявлять
encourage = воодушевлять, поощрять, побуждать
introduce = представлять (напр. одного человека другому)
refuse = отказываться
express = выражать
settle = улаживать (вопрос)
cry = плакать (кричать)
insist = настаивать
ignore = игнорировать
deny = отрицать
promise = обещать
demand = требовать
welcome = приветствовать
invite = приглашать
repeat = повторять
recommend = рекомендовать
propose = предлагать
declare = объявлять
matter (It doesn’t matter) = иметь значение
judge = судить, осуждать
ensure = обеспечивать (гарантировать, убеждаться в чем-то)
challenge = бросать вызов
warn = предупреждать
influence = влиять
blame = винить
complain = жаловаться
back = поддерживать, отступать
cite = цитировать (ссылаться)
emphasize = подчеркивать (делать ударение на чем-то)
decline = отклонять (напр. предложение)
accuse = обвинять
reject = отвергать
convince = убеждать
approve = подтверждать, одобрять
list = перечислять, составлять список
permit = разрешать
scream = кричать
shout = выкрикивать, кричать
inform = информировать
bother = беспокоить
reply = отвечать
resolve = решать (вопрос)
contact = контактировать, связываться
interview = проводить интервью (беседу)
quote = цитировать
urge = торопить
whisper = шептать
favor (favour) = оказывать внимание, быть благосклонным
comment = коментировать
negotiate = вести переговоры
advise = советовать
criticize = критиковать
assure = уверять
yell = кричать
communicate = общаться
disagree = не соглашаться
proceed = переходить к чему-то, продолжать как запланировано
translate = переводить (лингв.)
interpret = толковать, интерпретировать, переводить (устно)
pause = делать паузу
imply = предполагать, подразумевать, намекать
respect = уважать
characterize = характеризовать
appeal = обращаться, апеллировать
stress = делать ударение, подчеркивать (в речи)
doubt = сомневаться
guarantee = гарантировать
honor = чтить, уважать
encounter = встречать (случайно встретить кого-то)
dominate = доминировать, иметь полный контроль
accept = принимать
let (let, let) = позволять
date = встречаться, ходить на свидания
