cost (cost, cost) = стоить
earn = зарабатывать
make money (made, made) = зарабатывать
promote = продвигать, рекламировать, повышать по службе
charge = брать плату
estimate = оценивать
account = считать, вести учет
invest = инвестировать
assess = оценивать
compete = конкурировать
purchase = покупать
evaluate = оценивать
trade = торговать
market = продвигать на рынке (рекламировать)
withdraw = снимать (деньги со счета в банке)
convert = конвертировать
spend (spent, spent) = тратить (напр. деньги), проводить время
buy (bought, bought) = покупать
sell (sold, sold) = продавать
deal (dealt, dealt) = вести дела
produce = производить
save = делать сбережения, экономить
rule = править (властвовать)
elect = выбирать (на выборах)
vote = голосовать
contribute = вносить вклад во что-то
settle = расселяться (создавать поселение)
impose = налагать (напр. обязательство)
transfer = передавать, переводить (напр. деньги)
distribute = распространять
deposit = вносить деньги (на счет в банке)
afford = повзволять себе
