go (went, gone) = идти
come (came, come) = приходить
turn = поворачивать
run (ran, run) = бежать
move = двигать\двигаться
bring (brought, brought) = приносить
sit (sat, sat) = сидеть
stand (stood, stood) = стоять
follow = следовать
stop = останавливать\останавливаться
walk = ходить (гулять)
appear = появляться
disappear = исчезать
remain = оставаться
leave (left, left) = уходить\покидать
raise = поднимать\подниматься
carry = нести
drive (drove, driven) = вести машину
throw (threw, torown) = бросать
push = толкать
lay (laid, laid) = класть
lie (lay, lain) = лежать\лгать
arrive = прибывать
shake (shook, shaken) = трясти
fly (flew, flown) = летать
stay = оставаться
fall (fell, fallen) = падать
wear (wore, worn) = носить (напр. одежду)
step = шагнуть
roll = катиться, сворачивать
ride (rode, ridden) = ехать (напр. верхом)
lift = поднимать
jump = прыгать
approach = приближаться
cross = пересекать
climb = лезть (карабкаться)
bear (bore, born) = нести
shift = сдвигать
slip = поскальзываться
rush = торопиться (стремительно мчаться)
land = приземляться
escape = сбегать
drag = тащить (нести волоком)
slide (slid, slid) = скользить
toss = бросать (метать)
to flip a coin = подбросить монетку
accompany = сопровождать
swing (swung, swung) = раскачивать
swing = качели
advance = продвигаться
swim (swam, swum) = плыть
flee = убегать, спасаться бегством
sink (sank, sunk) = тонуть
Turn down = отказываться, отклонять что-то.
Turn on/off = включать/выключать (прибор).
Turn off the machine = Выключите станок.
Turn out = оказываться кем-то, случаться.
Turn up/down = Сделать звук громче/тише.
to run out of something = исчерпывать запасы чего-то, что-то заканчивается.
to bear = нести
tray = поднос
