teach (taught, taught) = учить (обучать)
can (could) = мочь, быть способным
know (knew, known) = знать
think (thought, thought) = думать
see (saw, seen) = видеть
want = хотеть
look = смотреть, выглядеть
need = нуждаться
feel (felt, felt) = чувствовать
mean (meant, meant) = значить (иметь ввиду)
seem = казаться
hear (heard, heard) = слышать
like = нравиться (любить)
believe = верить
learn (learnt, learnt) = изучать
watch = смотреть (сторожить)
read (read, read) = читать
remember = помнить
love = любить
decide = решать
hope = надеяться
listen = слушать
focus = сосредоточиваться (на чем-либо)
plan = планировать
note = замечать, обращать внимание
identify = идентифицировать
explore = исследовать
predict = предсказывать
acknowledge = признавать, подтверждать получение
fear = бояться
conclude = делать вывод
prefer = предпочитать
appreciate = ценить
trust = доверять
rely on = полагаться на
question = подвергать сомнению, допрашивать
regard = учитывать, считать кем-либо, чем-либо
suspect = подозревать
suppose = предполагать
perceive = воспринимать
inspire = вдохновлять
analyze = анализировать
concentrate = сосредоточиваться
smell (smelt, smelt) = нюхать, пахнуть
glance = смотреть (бросать взгляд)
dream (dreamt, dreamt) = мечать (видеть сны)
react = реагировать
choose = выбирать
expect = ожидать
miss = упускать, скучать
realize = реализовать, осознавать
determine = определять
recognize = узнавать
compare = сравнивать
miss (someone) = скучать (по кому-то\чему-то)
study = изучать (учиться)
forget (forgot, forgot) = забывать
imagine = воображать
discover = совершать открытие
worry = беспокоиться
wait = ждать
experience = переживать (испытывать что-то на себе)
tend = иметь склонность (к чему-то)
notice = замечать
wish = желать
figure out = выяснять (находить решение)
suffer = страдать
recall = вспоминать
stare = пристально смотреть, пялиться
examine = проверять (изучать)
define = определять
observe = наблюдать
count = считать
associate = ассоциировать (с чем-то)
view = смотреть
remind = напоминать
hate = ненавидеть
intend = намереваться
