be (was, been) = быть
exist = существовать
include = включать (в себя что-либо)
exclude = исключать
add = добавлять
enter = вводить, входить
share = делиться
remove = удалять
receive = получать
lose (lost, lost) = терять
find (found, found) = найти
have (had, had) = иметь
be present = присутствовать
be absent = отсутствовать
get (got, got\gotten) = получить (становиться)
take (took, taken) = брать
give (gave, given) = давать
return = возвращать
join = присоединять
involve = вовлекать
release = выпускать (отпускать)
own = владеть
gain = получать, набирать (прибавлять в чем-то)
emerge = появляться
expand = расширять (-ся)
disappear = исчезать
obtain = получать
belong = принадлежать
limit = ограничивать
spread (spread, spread) = распространять (-ся)
extend = расширять (-ся)
acquire = приобретать (получать)
abandon = покидать
arise (arose, arisen) = возникать
possess = обладать (владеть)
leave (left, left) = оставить
occupy = занимать (место)
