straight = прямой
bald = лысый
moustache = усы
beard = борода
wrinkles = морщины
average = средний\среднестатистический
in order to = для того чтобы
toolkit = набор инструментов
either ... or = или ... или
scruffy = нечесаный
elegant = элегантный\стильный\шикарный\изящный
cute = милый
handsome = красивый\статный(только дл мужчин)
pretty(which) = симпатичный\красивый(преимущественно для женщин)
pretty(how) = достаточно\вполне\в значительной степени
ugly = уродливый
suit = мужской костюм\костюм
jeans = джинсы
casual = повседневный
tie (clothes) = галстук
tie(game) = ничья
tie(глагол) = завязывать\зашнуровывать
t-shirt = футболка
belt = ремень
boots = сапоги
shirt = рубашка
shoes = туфли
smart(clothes) = строгий(наряд)\парадный(наряд)
smart(which) = умный
coat = пальто
scarf = шарф
waist = талия
to suit = подходить(этот костюм тебе идет)
suit(в отеле) = номер(повышенной комфортности)
to take off = снимать(одежду, обувь)
to fit = подходить(в физическом плане)\подходить по размеру
to match(clothes) = подходить(в плане к остальной одежде)\сочетаться(с другой одеждой)
odd(adjective) = странный\необычный\лишний\нечетный
sandals = сандалии\босоножки
high-heeled shoes = туфли на высоком каблуке
jumper = свитер
skirt = юбка
gloves = перчатки
cap = кепка
necklace = ожерелье\колье
earrings = серьги\сережки
trousers = брюки\штаны
jacket = пиджак
shorts = шорты
fussy = переживающий\нервный\суетливый

complete the sentences with words derived from the words in bold - дополните предложения словами, образованными от слов, выделенных жирным шрифтом

to drag = перетаскивать
that's it = вот и все
check out something = оценить что-то\заценить что-то
to look forward to doing something = ждать чего-то с нетерпением
recently = совсем недавно\недавно\в последнее время\на днях
lately = в последнее время\недавно\за последнее время\на днях
in a long time = в течении длительного времени