to be in a hurry = спешить\торопиться
to stay = оставаться
to visit = посещать\навещать\приходить с визитом
expensive = дорогой
cheap = дешевый
to spell = произносить по буквам
rich = богат\богатый
to provide = предоставлять\поставлять
comprehensive = всеобъемлющий\всесторонний\подробный
session = сеанс\занятие(учеба)\встреча(учеба, работа)
to supervise = курировать\следить за\контролировать
complex = сложный(задача)\непростой(задача)\трудный(задача)
issue = проблема\вопрос\тема\номер(журнала, газеты)

to devote = уделять\посвящать\уделить\посвятить(себя чему-то)
(нематериальные обьекты)

to dedicate = уделять\посвящать\уделить\посвятить(что-то кому-то)
(материальные обьекты)

devoted = преданный(сильнее чем dedicated)
dedicated = преданный(слабее чем devoted)

interchangeable = взаимозаменяемый
aspect = фактор\момент\составляющая
outcome = результат\исход\итог

bottom = низ\дно
top = верх
misery = нищета
luxury = роскошь
joyful = радостный
upset = расстроенный
blame = обвинять
justify = оправдывать