reliable = надежный
freckles = веснушки
grumpy = сердитый\сварливый\раздражительный
impatient = нетерпеливый
appear to be = казаться\выглядеть
possessions = имущество\собственность
jealous = ревнивый\завистливый
to jealous = ревновать\завидовать(first letter j)
to be jealous of = завидовать чему-то
to envy = завидовать
to break up = расстаться
to break down = сломаться
wet = мокрый\влажный
dry = сухой
ray = луч
bolt = вспышка
it's pouring with rain = идет дождь(льет как из ведра)\дождь льет как из ведра\льет как из ведра(дождь)\сильный дождь
thick fog = густой туман
freezing cold = мороз
soaking wet = промокший насквозь\промокший до нитки
heavy shower = ливень
snowing heavily = снегопад\сильный снегопад
snowflake = снежинка
earthquake = землетрясение
drought = засуха
volcanic eruption = извержение вулкана
to spill = проливать(что-то)\разливать(что-то)
flood = наводнение
drowning = утопление
to leak = утекать\протекать\вытекать(газ, жидкость)
leak = утечка
poisoning = отравление
shipwreck = кораблекрушение
crew = команда\экипаж\бригада
manned = пилотируемый\управляемый\управляемый людьми
explosion = взрыв
plot = сюжет
against = вопреки\против\несмотря на
doomed = обреченный
to be in charge of = отвечать за(что-то)\быть ответственным за(что-то)
shedule = рассписание
to shedule = планировать\составлять расписание
lift off = отрыв от земли\взлет\старт
supposed to be = должно быть
to take off = взлететь\взлетать\оторваться от земли\отрываться от земли
it's dripping with rain = моросит\моросит дождь\капает дождь\слабый дождь
boiling hot = жара\очень жарко
poison = яд
mature = возмужавший\тот который приобрел качества взрослой особи(и морально и физически)
tough = грубый\жесткий
bumpy = неровный\с кочками(дорога)\с изгибами
to bump = стукнуть\стукнуться(обо что-то)
injury = травма\увечие
to scratch = царапать
scratches = царапины
twist = оборот\вывих\прокручивание
to turn = повернуть
to milk = доить(корову)
to water = поливать
to google = искать(в интернете)
to screw = закручивать(болт)
to piss off = бесить\раздражать\действовать на нервы
give or take = плюс минус
to saw = пилить(пилкой по дереву)
bush = куст
swollen = распухший\отекший\надутый(не с помощью воздуха)\опухший\напухший
to blow up = надуть(с помощью воздуха)\надувать
cast(травма) = гипс
cast(фильм) = состав(людей)
bruise = синяк
to puff = тяжело дышать\глубоко дышать\громко дышать
