requirement = требование\условие\потребность
specification = описание\спецификация\уточнение
further = дальнейший\дополнительный
article = статья
so that = чтобы\поэтому\так что
to suspect = подозревать\заподозрить
validation = проверка\подтверждение
cell = ячейка
to suppose = предпологать\допускать\думать\полагать
enjoy your meal = приятного аппетита(first letter e)
bon appetit = приятного аппетита(f. l. b)
to put off = отложить(время)\откладывать(время)\перенести(время)\переносить(время)
to put out(fire) = погасить\затушить\тушить\потушить
to put out = выкладывать(вещи)\доставать(вещи)
to put somebody through to = соединить по телефону\связать по телефону\связывать по телефону\соединять по телефону
to put up with = мириться с\терпеть\смириться с
to rescue = спасать\спасти\прийти на выручку\приходить на выручку\выручать
treatment = лечение\уход(за кем-то)
data treatment = обработка данных
discovery = открытие
ancient = древний\старинный\старый\античный\стародавний
robbery = ограбление\грабеж\кража\разбой
to cause = быть причиной

to set off = отправиться(куда-то)
to make excuses = оправдываться
cuisine = кухня\кулинарное искусство
though = хотя\однако\хоть
stomach = живот
fine = отлично\отличный\хорошо\хороший\прекрасно\прекрасный
awful = ужасный\внушающий страх(f. l. a)
terrible = ужасный(f. l. t)\страшный\внушающий страх\внушающий ужас(f. l. t)
to get stung = быть ужаленным
to get stunned = быть ошеломленным(чем-то)
to get bitten = быть укушеным
sunburn = солнечный ожог
suntan = загар\солнечный загар
to narrate = рассказывать\повествовать
roar = рык\рев
to roar = рычать\реветь
to scream = орать\кричать
to struck = ударить(он ударил ее)\поразить(меня это поразило)
fear = страх\боязнь\опасение
to froze in fear = замереть от страха
terrifying = ужасающий
to push = толкать\нажимать\проталкивать
to float = плавать(f. l. f)\всплывать\плавать на поверхности
stair = лестница\ступенька\ступень
staircase = лестничная клетка\лестничный пролет
to grab onto = схватиться за(что-то)\ухватиться за\хвататься за
to held onto = держаться за
rail = поручень\перила
debris = обломки\развалины\осколки\строительный мусор
upside down = с ног на голову\вверх дном
wrist = запястье\наручный
handcuffs = наручники
to separate = разнимать\разъединять\разделять
eventually = в итоге\в конечном счете\в конце концов\со временем
relief = облегчение
to get relieved = вздохнуть с облегчением (?)
to shout = кричать(f. l. s)\крикнуть\окликнуть(?)
additional = дополнительный
suitable – подходящий\соответствующий
compound = соединение(химическое)\составное слово
combining = объединение
particularly = особенно\в частности\в особенности\очень\чрезвычайно\особым образом
slightly = немного\слегка\чуть\едва
intelligent = умный\смышленый
trafficlight = светофор
two seater = двухместный(автомобиль)
scuba = акваланг
short tempered(person) = вспыльчивый\раздражительный\несдержанный
to be amount to = быть равным(чему-то)
amount = количество\сумма
worn out = измученный\усталый\изношенный\поношенный