top = верхний (главный)
right = правильный (правый)
local = местный
available = доступный
central = центральный
left = левый (оставшийся)
close = близкий (закрытый)
far = далекий
deep = глубокий
middle = средний
western = западный
southern = южный
front = передний
eastern = восточный
northern = северный
internal = внутренний
upper = верхний
vast = широкий (обширный)
limited = ограниченный
outside = внешний
nearby = находящийся поблизости
inner = внутренний
biological = биологический
distant = удаленный
bottom = нижний
remote = удаленный (дистанционный)
external = внешний
lost = потерянный
extensive = обширный
natural = природный (естественный)
environmental = относящийся к окружающей среде
fresh = свежий
global = глобальный
wild = дикий
growing = растущий
living = живущий
racial = расовый
solar = солнечный (напр. Солнечная система)
existing = существующий
