sure = уверенный
able = способный (сделать что-то, быть кем-то)
human = человеческий
strong = сильный
free = свободный
certain = уверенный
personal = личный
single = одинокий (неженатый\незамужняя)
private = личный (напр. личная жизнь)
common = обычный, распространенный, общий
dead = мертвый
happy = счастливый
serious = серьезный
ready = готовый
simple = простой
religious = религиозный
individual = индивидуальный
tough = крепкий, сильный
positive = положительный
successful = успешный
concerned = обеспокоенный
willing = желающий (готовый к чему-то)
interested = заинтересованный
responsible = ответственный
afraid = испуганный
native = родной (язык), коренной (житель)
aware = знающий (осведомленный)
active = активный
chief = главный
cool = крутой (клевый)
direct = прямой
famous = известный
familiar = знакомый
male = мужской
alive = живой
strange = странный
married = женатый (замужняя)
alone = одинокий
sick = больной
smart = умный
mean = подлый (злой)
surprised = удивленный
busy = занятый
careful = осторожный
tired = уставший
proud = гордый
healthy = здоровый
creative = творческий
lucky = везучий
silent = молчаливый
leading = ведущий
glad = довольный
fat = полный (о фигуре)
slim = стройный (о фигуре)
lean = стройный, тощий (о фигуре)
nervous = нервный
pretty = симпатичная (о женщине)
handsome = симпатичный (о мужчине)
sensitive = чувствительный
reasonable = разумный
aggressive = агрессивный
mad = безумный
pregnant = беременная
stupid = глупый
blind = слепой
friendly = дружелюбный
innocent = невиновный
attractive = привлекательный
intellectual = интеллектуальный
confident = уверенный
pale = бледный
ill = больной
scared = испуганный
capable = способный
fellow = товарищеский
advanced = продвинутый (расширенный)
favorite = любимый
wonderful = чудесный
emotional = эмоциональный
angry = сердитый
crazy = сумасшедший
interesting = интересный
fun = веселый
spiritual = духовный
dramatic = драматичный
sad = грустный
amazing = удивительный
psychological = психологический
surprising = удивительный
exciting = увлекательный (захватывающий)
