clear = ясный
open = открытый
hot = горячий
cold = холодный
heavy = тяжелый
tough = жесткий
powerful = мощный
quick = быстрый
soft = мягкий
quiet = тихий
cool = прохладный
dry = сухой
slow = медленный
solid = твердый
sharp = острый (предмет, звук)
live = живой (в т.ч в значении «прямой эфир»)
mass = массовый
smooth = гладкий
wet = мокрый
fast = быстрый
rough = грубый
tight = плотный
raw = сырой
dirty = грязный
still = замерший
pure (water) = чистый (без примесей)
steady = устойчивый
stable = стабильный
vulnerable = уязвимый
loose = свободный (ненатянутый, напр. об одежде)
accurate = точный
whole = весь (целиком)
full = полный
physical = физический
entire = весь (целиком)
clean = чистый
empty = пустой
golden = золотой
wooden = деревянный
broken = сломанный
visual = визуальный
