national = национальный
political = политический
social = социальный, общественный
public = общественный, государственный
military = военный
federal = федеральный
international = международный
foreign = иностранный
democratic = демократический
legal = законный (правовой)
traditional = традиционный
cultural = культурный
civil = гражданский
safe = безопасный
nuclear = ядерный
independent = независимый
united = объединенный
domestic = домашний (внутренний — в политич.смысле)
corporate = корпоративный
urban = городской
regional = региональный
ethnic = этнический
conservative = консервативный
industrial = промышленный
historical = исторический
presidential = президентский
liberal = либеральный
rural = сельский
historic = исторический
armed = вооруженный
constitutional = конституционный
strategic = стратегический
defensive = оборонительный
joint = совместный
mutual = взаимный
official = официальный
